0123401234
0123401234
4321043210
DDDDDDDDDD
BBBBBBBBBB
XXXXXXXXXX
XXXXXXXXXX
XXXXXXXXXX
